#domain
hospital
#levelname
BFSfriendly
#colors
blue: 0
#initial
++++++++++++++++++++
+0                 +
+                  +
+  +++++++++++++++ +
+                  +
+  ++++++++++++++ ++
+                  +
++++++++++++++++++++
#goal
++++++++++++++++++++
+                  +
+                  +
+  +++++++++++++++ +
+                  +
+  ++++++++++++++ ++
+0                 +
++++++++++++++++++++
#end
